ZONAT	ZONER v. [cj. aimer]. Inf. Partager (un ensemble d’informations) en portions homogènes.
ZONATES	ZONER v. [cj. aimer]. Inf. Partager (un ensemble d’informations) en portions homogènes.
ZONATION	ZONATION n.f. Géogr. Division de la Terre en zones.
ZONATIONS	ZONATION n.f. Géogr. Division de la Terre en zones.
ZONAUX	ZONAL, E, AUX adj. Géol. Relatif à une zone de la Terre. - Zool. À bandes transversales colorées.
ZONE	ZONE n.f.
ZONEE	ZONÉ, E adj. Qui présente des zones d’aspects différents.
ZONEES	ZONÉ, E adj. Qui présente des zones d’aspects différents.
ZONENT	ZONER v. [cj. aimer]. Inf. Partager (un ensemble d’informations) en portions homogènes.
ZONER	ZONER v. [cj. aimer]. Inf. Partager (un ensemble d’informations) en portions homogènes.
ZONERA	ZONER v. [cj. aimer]. Inf. Partager (un ensemble d’informations) en portions homogènes.
ZONERAI	ZONER v. [cj. aimer]. Inf. Partager (un ensemble d’informations) en portions homogènes.
ZONERAIENT	ZONER v. [cj. aimer]. Inf. Partager (un ensemble d’informations) en portions homogènes.
ZONERAIS	ZONER v. [cj. aimer]. Inf. Partager (un ensemble d’informations) en portions homogènes.
ZONERAIT	ZONER v. [cj. aimer]. Inf. Partager (un ensemble d’informations) en portions homogènes.
ZONERAS	ZONER v. [cj. aimer]. Inf. Partager (un ensemble d’informations) en portions homogènes.
ZONERENT	ZONER v. [cj. aimer]. Inf. Partager (un ensemble d’informations) en portions homogènes.
ZONEREZ	ZONER v. [cj. aimer]. Inf. Partager (un ensemble d’informations) en portions homogènes.
ZONERIEZ	ZONER v. [cj. aimer]. Inf. Partager (un ensemble d’informations) en portions homogènes.
ZONERIONS	ZONER v. [cj. aimer]. Inf. Partager (un ensemble d’informations) en portions homogènes.
ZONERONS	ZONER v. [cj. aimer]. Inf. Partager (un ensemble d’informations) en portions homogènes.
ZONERONT	ZONER v. [cj. aimer]. Inf. Partager (un ensemble d’informations) en portions homogènes.
ZONES	ZONE n.f.
ZONEZ	ZONER v. [cj. aimer]. Inf. Partager (un ensemble d’informations) en portions homogènes.
ZONIER	ZONIER, ÈRE adj. et n. Vx. (Habitant) de la zone autour de Paris.
ZONIERE	ZONIER, ÈRE adj. et n. Vx. (Habitant) de la zone autour de Paris.
ZONIERES	ZONIER, ÈRE adj. et n. Vx. (Habitant) de la zone autour de Paris.
ZONIERS	ZONIER, ÈRE adj. et n. Vx. (Habitant) de la zone autour de Paris.
ZONIEZ	ZONER v. [cj. aimer]. Inf. Partager (un ensemble d’informations) en portions homogènes.
ZONING	ZONING n.m. Belg. Zone industrielle.
ZONINGS	ZONING n.m. Belg. Zone industrielle.
ZONIONS	ZONER v. [cj. aimer]. Inf. Partager (un ensemble d’informations) en portions homogènes.
ZONONS	ZONER v. [cj. aimer]. Inf. Partager (un ensemble d’informations) en portions homogènes.
ZONURE	ZONURE n.m. Reptile saurien carnivore d’Afrique du Sud.
ZONURES	ZONURE n.m. Reptile saurien carnivore d’Afrique du Sud.
ZOO	ZOO n.m.
ZOOCHORE	ZOOCHORE adj. (Végétal) dont les graines sont dispersées par les animaux.
ZOOCHORES	ZOOCHORE adj. (Végétal) dont les graines sont dispersées par les animaux.
ZOOCHORIE	ZOOCHORIE n.f.
ZOOCHORIES	ZOOCHORIE n.f.
ZOOFLAGELLE	ZOOFLAGELLÉ n.m. Organisme unicellulaire non chlorophyllien à flagelles.
ZOOFLAGELLES	ZOOFLAGELLÉ n.m. Organisme unicellulaire non chlorophyllien à flagelles.
ZOOGAMETE	ZOOGAMÈTE n.m. Gamète mobile.
ZOOGAMETES	ZOOGAMÈTE n.m. Gamète mobile.
ZOOGENE	ZOOGÈNE adj. D’origine animale.
ZOOGENES	ZOOGÈNE adj. D’origine animale.
ZOOGEOGRAPHIE	ZOOGÉOGRAPHIE n.f. Étude de la répartition de la vie animale sur la Terre.
ZOOGEOGRAPHIES	ZOOGÉOGRAPHIE n.f. Étude de la répartition de la vie animale sur la Terre.
ZOOGEOGRAPHIQUE	ZOOGÉOGRAPHIQUE adj.
ZOOGEOGRAPHIQUES	ZOOGÉOGRAPHIQUE adj.
ZOOGLEE	ZOOGLÉE n.f. Substance gélatineuse constituée de bactéries agglutinées.
ZOOGLEES	ZOOGLÉE n.f. Substance gélatineuse constituée de bactéries agglutinées.
ZOOIDE	ZOOÏDE adj. (Fossile) qui porte l’empreinte d’un animal ou d’une partie d’animal.
ZOOIDES	ZOOÏDE adj. (Fossile) qui porte l’empreinte d’un animal ou d’une partie d’animal.
ZOOLATRE	ZOOLÂTRE adj. et n. Qui adore les animaux.
ZOOLATRES	ZOOLÂTRE adj. et n. Qui adore les animaux.
ZOOLATRIE	ZOOLÂTRIE n.f.
ZOOLATRIES	ZOOLÂTRIE n.f.
ZOOLITE	ZOOLITE n.m. (= zoolithe) Débris fossile ou pétrifié d’un animal.
ZOOLITES	ZOOLITE n.m. (= zoolithe) Débris fossile ou pétrifié d’un animal.
ZOOLITHE	ZOOLITHE n.m. (= zoolite) Débris fossile ou pétrifié d’un animal.
ZOOLITHES	ZOOLITHE n.m. (= zoolite) Débris fossile ou pétrifié d’un animal.
ZOOLOGIE	ZOOLOGIE n.f.
ZOOLOGIES	ZOOLOGIE n.f.
ZOOLOGIQUE	ZOOLOGIQUE adj.
ZOOLOGIQUEMENT	ZOOLOGIQUEMENT adv.
ZOOLOGIQUES	ZOOLOGIQUE adj.
ZOOLOGISTE	ZOOLOGISTE n.
ZOOLOGISTES	ZOOLOGISTE n.
ZOOLOGUE	ZOOLOGUE n.
ZOOLOGUES	ZOOLOGUE n.
ZOOM	ZOOM n.m.
ZOOMA	ZOOMER v. [cj. aimer]. Filmer en utilisant un zoom.
ZOOMABLE	ZOOMABLE adj.
ZOOMABLES	ZOOMABLE adj.
ZOOMAI	ZOOMER v. [cj. aimer]. Filmer en utilisant un zoom.
ZOOMAIENT	ZOOMER v. [cj. aimer]. Filmer en utilisant un zoom.
ZOOMAIS	ZOOMER v. [cj. aimer]. Filmer en utilisant un zoom.
ZOOMAIT	ZOOMER v. [cj. aimer]. Filmer en utilisant un zoom.
ZOOMAMES	ZOOMER v. [cj. aimer]. Filmer en utilisant un zoom.
ZOOMANT	ZOOMER v. [cj. aimer]. Filmer en utilisant un zoom.
ZOOMAS	ZOOMER v. [cj. aimer]. Filmer en utilisant un zoom.
ZOOMASSE	ZOOMER v. [cj. aimer]. Filmer en utilisant un zoom.
ZOOMASSENT	ZOOMER v. [cj. aimer]. Filmer en utilisant un zoom.
ZOOMASSES	ZOOMER v. [cj. aimer]. Filmer en utilisant un zoom.
ZOOMASSIEZ	ZOOMER v. [cj. aimer]. Filmer en utilisant un zoom.
ZOOMASSIONS	ZOOMER v. [cj. aimer]. Filmer en utilisant un zoom.
ZOOMAT	ZOOMER v. [cj. aimer]. Filmer en utilisant un zoom.
ZOOMATES	ZOOMER v. [cj. aimer]. Filmer en utilisant un zoom.
ZOOME	ZOOMER v. [cj. aimer]. Filmer en utilisant un zoom.
ZOOMEE	ZOOMER v. [cj. aimer]. Filmer en utilisant un zoom.
ZOOMEES	ZOOMER v. [cj. aimer]. Filmer en utilisant un zoom.
ZOOMENT	ZOOMER v. [cj. aimer]. Filmer en utilisant un zoom.
ZOOMER	ZOOMER v. [cj. aimer]. Filmer en utilisant un zoom.
ZOOMERA	ZOOMER v. [cj. aimer]. Filmer en utilisant un zoom.
ZOOMERAI	ZOOMER v. [cj. aimer]. Filmer en utilisant un zoom.
ZOOMERAIENT	ZOOMER v. [cj. aimer]. Filmer en utilisant un zoom.
ZOOMERAIS	ZOOMER v. [cj. aimer]. Filmer en utilisant un zoom.
ZOOMERAIT	ZOOMER v. [cj. aimer]. Filmer en utilisant un zoom.
ZOOMERAS	ZOOMER v. [cj. aimer]. Filmer en utilisant un zoom.
ZOOMERENT	ZOOMER v. [cj. aimer]. Filmer en utilisant un zoom.
ZOOMEREZ	ZOOMER v. [cj. aimer]. Filmer en utilisant un zoom.
ZOOMERIEZ	ZOOMER v. [cj. aimer]. Filmer en utilisant un zoom.
ZOOMERIONS	ZOOMER v. [cj. aimer]. Filmer en utilisant un zoom.
ZOOMERONS	ZOOMER v. [cj. aimer]. Filmer en utilisant un zoom.
ZOOMERONT	ZOOMER v. [cj. aimer]. Filmer en utilisant un zoom.
ZOOMES	ZOOMER v. [cj. aimer]. Filmer en utilisant un zoom.
ZOOMEZ	ZOOMER v. [cj. aimer]. Filmer en utilisant un zoom.
ZOOMIEZ	ZOOMER v. [cj. aimer]. Filmer en utilisant un zoom.
ZOOMIONS	ZOOMER v. [cj. aimer]. Filmer en utilisant un zoom.
ZOOMONS	ZOOMER v. [cj. aimer]. Filmer en utilisant un zoom.
ZOOMORPHE	ZOOMORPHE adj. (= zoomorphique) Dont la forme rappelle celle d’un animal.
ZOOMORPHES	ZOOMORPHE adj. (= zoomorphique) Dont la forme rappelle celle d’un animal.
ZOOMORPHIQUE	ZOOMORPHIQUE adj. (= zoomorphe) Dont la forme rappelle celle d’un animal.
ZOOMORPHIQUES	ZOOMORPHIQUE adj. (= zoomorphe) Dont la forme rappelle celle d’un animal.
ZOOMORPHISME	ZOOMORPHISME n.m. Métamorphose en animal.
ZOOMORPHISMES	ZOOMORPHISME n.m. Métamorphose en animal.
ZOOMS	ZOOM n.m.
ZOONOSE	ZOONOSE n.f. Maladie des animaux pouvant se transmettre à l’homme.
ZOONOSES	ZOONOSE n.f. Maladie des animaux pouvant se transmettre à l’homme.
ZOOPATHIE	ZOOPATHIE n.f. (= zoanthropie) Psych. Délire d’un malade qui se croit habité par un animal.
ZOOPATHIES	ZOOPATHIE n.f. (= zoanthropie) Psych. Délire d’un malade qui se croit habité par un animal.
ZOOPATHIQUE	ZOOPATHIQUE adj.
ZOOPATHIQUES	ZOOPATHIQUE adj.
ZOOPHAGE	ZOOPHAGE adj. et n.m. (Insecte) qui se nourrit de proies animales.
ZOOPHAGES	ZOOPHAGE adj. et n.m. (Insecte) qui se nourrit de proies animales.
ZOOPHILE	ZOOPHILE adj. et n. (Personne) qui a des relations sexuelles avec des animaux.
ZOOPHILES	ZOOPHILE adj. et n. (Personne) qui a des relations sexuelles avec des animaux.
ZOOPHILIE	ZOOPHILIE n.f.
ZOOPHILIES	ZOOPHILIE n.f.
ZOOPHOBIE	ZOOPHOBIE n.f. Psych. Angoisse liée à la présence d’animaux.
ZOOPHOBIES	ZOOPHOBIE n.f. Psych. Angoisse liée à la présence d’animaux.
ZOOPHORE	ZOOPHORE n.m. Antiq. Frise ornée d’animaux.
ZOOPHORES	ZOOPHORE n.m. Antiq. Frise ornée d’animaux.
ZOOPHYTE	ZOOPHYTE n.m. Animal ayant l’aspect d’une plante.
ZOOPHYTES	ZOOPHYTE n.m. Animal ayant l’aspect d’une plante.
ZOOPLANCTON	ZOOPLANCTON n.m. Partie animale du plancton.
ZOOPLANCTONS	ZOOPLANCTON n.m. Partie animale du plancton.
ZOOPSIE	ZOOPSIE n.f. Psych. Hallucination dans laquelle le sujet voit des animaux terrifiants.
ZOOPSIES	ZOOPSIE n.f. Psych. Hallucination dans laquelle le sujet voit des animaux terrifiants.
ZOOS	ZOO n.m.
ZOOSEMIOTIQUE	ZOOSÉMIOTIQUE n.f. Étude des communications animales.
ZOOSEMIOTIQUES	ZOOSÉMIOTIQUE n.f. Étude des communications animales.
ZOOSPORANGE	ZOOSPORANGE n.m. Bot. Sporange renfermant des zoospores.
ZOOSPORANGES	ZOOSPORANGE n.m. Bot. Sporange renfermant des zoospores.
ZOOSPORE	ZOOSPORE n.f. Bot. Spore mobile de certaines algues.
ZOOSPORES	ZOOSPORE n.f. Bot. Spore mobile de certaines algues.
ZOOTAXIE	ZOOTAXIE n.f. Classification des animaux.
ZOOTAXIES	ZOOTAXIE n.f. Classification des animaux.
ZOOTECHNICIEN	ZOOTECHNICIEN, ENNE n.
ZOOTECHNICIENNE	ZOOTECHNICIEN, ENNE n.
ZOOTECHNICIENNES	ZOOTECHNICIEN, ENNE n.
ZOOTECHNICIENS	ZOOTECHNICIEN, ENNE n.
ZOOTECHNIE	ZOOTECHNIE n.f. Étude des animaux domestiques en vue de l’amélioration des races.
ZOOTECHNIES	ZOOTECHNIE n.f. Étude des animaux domestiques en vue de l’amélioration des races.
ZOOTECHNIQUE	ZOOTECHNIQUE adj.
ZOOTECHNIQUES	ZOOTECHNIQUE adj.
ZOOTHEQUE	ZOOTHÈQUE n.f. Musée d’animaux naturalisés.
ZOOTHEQUES	ZOOTHÈQUE n.f. Musée d’animaux naturalisés.
ZOOTHERAPIE	ZOOTHÉRAPIE n.f. Thérapie qui exploite les bienfaits de la présence d’animaux.
ZOOTHERAPIES	ZOOTHÉRAPIE n.f. Thérapie qui exploite les bienfaits de la présence d’animaux.
ZOOTROPE	ZOOTROPE n.m. Jouet donnant l’illusion du mouvement.
ZOOTROPES	ZOOTROPE n.m. Jouet donnant l’illusion du mouvement.
ZOREILLE	ZOREILLE n. Fam. Habitant de la Nouvelle-Calédonie ou de la Réunion né en France métropolitaine.
ZOREILLES	ZOREILLE n. Fam. Habitant de la Nouvelle-Calédonie ou de la Réunion né en France métropolitaine.
ZORILLE	ZORILLE n.f. Mammifère carnassier à fourrure estimée.
ZORILLES	ZORILLE n.f. Mammifère carnassier à fourrure estimée.
ZOROASTRIEN	ZOROASTRIEN, ENNE adj. et n. Relatif au zoroastrisme.
ZOROASTRIENNE	ZOROASTRIEN, ENNE adj. et n. Relatif au zoroastrisme.
ZOROASTRIENNES	ZOROASTRIEN, ENNE adj. et n. Relatif au zoroastrisme.
ZOROASTRIENS	ZOROASTRIEN, ENNE adj. et n. Relatif au zoroastrisme.
ZOROASTRISME	ZOROASTRISME n.m. Mazdéisme réformé.
ZOROASTRISMES	ZOROASTRISME n.m. Mazdéisme réformé.
ZORSE	ZORSE n.m. (= zébrule) Hybride de zèbre et de jument.
ZORSES	ZORSE n.m. (= zébrule) Hybride de zèbre et de jument.
ZOSTERE	ZOSTÈRE n.f. Plante vivace formant des prairies sous-marines.
ZOSTERES	ZOSTÈRE n.f. Plante vivace formant des prairies sous-marines.
ZOSTERIEN	ZOSTÉRIEN, ENNE adj. Méd. Relatif au zona.
ZOSTERIENNE	ZOSTÉRIEN, ENNE adj. Méd. Relatif au zona.
ZOSTERIENNES	ZOSTÉRIEN, ENNE adj. Méd. Relatif au zona.
ZOSTERIENS	ZOSTÉRIEN, ENNE adj. Méd. Relatif au zona.
ZOSTEROPS	ZOSTÉROPS n.m. Petit oiseau, dit oiseau-lunettes.
ZOU	ZOU interj.
ZOUAVE	ZOUAVE n.m.
ZOUAVES	ZOUAVE n.m.
ZOUGLOU	ZOUGLOU n.m. Musique de Côte d’Ivoire.
ZOUGLOUS	ZOUGLOU n.m. Musique de Côte d’Ivoire.
ZOUGOIS	ZOUGOIS, E adj. Du canton de Zoug (Suisse).
ZOUGOISE	ZOUGOIS, E adj. Du canton de Zoug (Suisse).
ZOUGOISES	ZOUGOIS, E adj. Du canton de Zoug (Suisse).
ZOUK	ZOUK n.m. Danse ou fête antillaise.
ZOUKA	ZOUKER v. (p.p.inv.) [cj. aimer]. Danser le zouk.
ZOUKAI	ZOUKER v. (p.p.inv.) [cj. aimer]. Danser le zouk.
ZOUKAIENT	ZOUKER v. (p.p.inv.) [cj. aimer]. Danser le zouk.
ZOUKAIS	ZOUKER v. (p.p.inv.) [cj. aimer]. Danser le zouk.
ZOUKAIT	ZOUKER v. (p.p.inv.) [cj. aimer]. Danser le zouk.
ZOUKAMES	ZOUKER v. (p.p.inv.) [cj. aimer]. Danser le zouk.
ZOUKANT	ZOUKER v. (p.p.inv.) [cj. aimer]. Danser le zouk.
ZOUKAS	ZOUKER v. (p.p.inv.) [cj. aimer]. Danser le zouk.
ZOUKASSE	ZOUKER v. (p.p.inv.) [cj. aimer]. Danser le zouk.
ZOUKASSENT	ZOUKER v. (p.p.inv.) [cj. aimer]. Danser le zouk.
ZOUKASSES	ZOUKER v. (p.p.inv.) [cj. aimer]. Danser le zouk.
ZOUKASSIEZ	ZOUKER v. (p.p.inv.) [cj. aimer]. Danser le zouk.
ZOUKASSIONS	ZOUKER v. (p.p.inv.) [cj. aimer]. Danser le zouk.
ZOUKAT	ZOUKER v. (p.p.inv.) [cj. aimer]. Danser le zouk.
ZOUKATES	ZOUKER v. (p.p.inv.) [cj. aimer]. Danser le zouk.
ZOUKE	ZOUKER v. (p.p.inv.) [cj. aimer]. Danser le zouk.
ZOUKENT	ZOUKER v. (p.p.inv.) [cj. aimer]. Danser le zouk.
ZOUKER	ZOUKER v. (p.p.inv.) [cj. aimer]. Danser le zouk.
ZOUKERA	ZOUKER v. (p.p.inv.) [cj. aimer]. Danser le zouk.
ZOUKERAI	ZOUKER v. (p.p.inv.) [cj. aimer]. Danser le zouk.
ZOUKERAIENT	ZOUKER v. (p.p.inv.) [cj. aimer]. Danser le zouk.
ZOUKERAIS	ZOUKER v. (p.p.inv.) [cj. aimer]. Danser le zouk.
ZOUKERAIT	ZOUKER v. (p.p.inv.) [cj. aimer]. Danser le zouk.
ZOUKERAS	ZOUKER v. (p.p.inv.) [cj. aimer]. Danser le zouk.
ZOUKERENT	ZOUKER v. (p.p.inv.) [cj. aimer]. Danser le zouk.
ZOUKEREZ	ZOUKER v. (p.p.inv.) [cj. aimer]. Danser le zouk.
ZOUKERIEZ	ZOUKER v. (p.p.inv.) [cj. aimer]. Danser le zouk.
ZOUKERIONS	ZOUKER v. (p.p.inv.) [cj. aimer]. Danser le zouk.
ZOUKERONS	ZOUKER v. (p.p.inv.) [cj. aimer]. Danser le zouk.
ZOUKERONT	ZOUKER v. (p.p.inv.) [cj. aimer]. Danser le zouk.
ZOUKES	ZOUKER v. (p.p.inv.) [cj. aimer]. Danser le zouk.
ZOUKEUR	ZOUKEUR, EUSE n.
ZOUKEURS	ZOUKEUR, EUSE n.
ZOUKEUSE	ZOUKEUR, EUSE n.
ZOUKEUSES	ZOUKEUR, EUSE n.
ZOUKEZ	ZOUKER v. (p.p.inv.) [cj. aimer]. Danser le zouk.
ZOUKIEZ	ZOUKER v. (p.p.inv.) [cj. aimer]. Danser le zouk.
ZOUKIONS	ZOUKER v. (p.p.inv.) [cj. aimer]. Danser le zouk.
ZOUKONS	ZOUKER v. (p.p.inv.) [cj. aimer]. Danser le zouk.
ZOUKS	ZOUK n.m. Danse ou fête antillaise.
ZOULOU	ZOULOU, E adj.
ZOULOUE	ZOULOU, E adj.
ZOULOUES	ZOULOU, E adj.
ZOULOUS	ZOULOU, E adj.
ZOURNA	ZOURNA n.f. Hautbois arabe.
ZOURNAS	ZOURNA n.f. Hautbois arabe.
ZOZO	ZOZO n.m. Fam. Niais.
ZOZOS	ZOZO n.m. Fam. Niais.
ZOZOTA	ZOZOTER v. (p.p.inv.) [cj. aimer].
ZOZOTAI	ZOZOTER v. (p.p.inv.) [cj. aimer].
ZOZOTAIENT	ZOZOTER v. (p.p.inv.) [cj. aimer].
ZOZOTAIS	ZOZOTER v. (p.p.inv.) [cj. aimer].
ZOZOTAIT	ZOZOTER v. (p.p.inv.) [cj. aimer].
ZOZOTAMES	ZOZOTER v. (p.p.inv.) [cj. aimer].
ZOZOTANT	ZOZOTER v. (p.p.inv.) [cj. aimer].
ZOZOTAS	ZOZOTER v. (p.p.inv.) [cj. aimer].
ZOZOTASSE	ZOZOTER v. (p.p.inv.) [cj. aimer].
ZOZOTASSENT	ZOZOTER v. (p.p.inv.) [cj. aimer].
ZOZOTASSES	ZOZOTER v. (p.p.inv.) [cj. aimer].
ZOZOTASSIEZ	ZOZOTER v. (p.p.inv.) [cj. aimer].
ZOZOTASSIONS	ZOZOTER v. (p.p.inv.) [cj. aimer].
ZOZOTAT	ZOZOTER v. (p.p.inv.) [cj. aimer].
ZOZOTATES	ZOZOTER v. (p.p.inv.) [cj. aimer].
ZOZOTE	ZOZOTER v. (p.p.inv.) [cj. aimer].
ZOZOTEMENT	ZOZOTEMENT n.m.
ZOZOTEMENTS	ZOZOTEMENT n.m.
ZOZOTENT	ZOZOTER v. (p.p.inv.) [cj. aimer].
ZOZOTER	ZOZOTER v. (p.p.inv.) [cj. aimer].
ZOZOTERA	ZOZOTER v. (p.p.inv.) [cj. aimer].
ZOZOTERAI	ZOZOTER v. (p.p.inv.) [cj. aimer].
ZOZOTERAIENT	ZOZOTER v. (p.p.inv.) [cj. aimer].
ZOZOTERAIS	ZOZOTER v. (p.p.inv.) [cj. aimer].
ZOZOTERAIT	ZOZOTER v. (p.p.inv.) [cj. aimer].
ZOZOTERAS	ZOZOTER v. (p.p.inv.) [cj. aimer].
ZOZOTERENT	ZOZOTER v. (p.p.inv.) [cj. aimer].
ZOZOTEREZ	ZOZOTER v. (p.p.inv.) [cj. aimer].
ZOZOTERIEZ	ZOZOTER v. (p.p.inv.) [cj. aimer].
ZOZOTERIONS	ZOZOTER v. (p.p.inv.) [cj. aimer].
ZOZOTERONS	ZOZOTER v. (p.p.inv.) [cj. aimer].
ZOZOTERONT	ZOZOTER v. (p.p.inv.) [cj. aimer].
ZOZOTES	ZOZOTER v. (p.p.inv.) [cj. aimer].
ZOZOTEUR	ZOZOTEUR, EUSE n.
ZOZOTEURS	ZOZOTEUR, EUSE n.
ZOZOTEUSE	ZOZOTEUR, EUSE n.
ZOZOTEUSES	ZOZOTEUR, EUSE n.
ZOZOTEZ	ZOZOTER v. (p.p.inv.) [cj. aimer].
ZOZOTIEZ	ZOZOTER v. (p.p.inv.) [cj. aimer].
ZOZOTIONS	ZOZOTER v. (p.p.inv.) [cj. aimer].
ZOZOTONS	ZOZOTER v. (p.p.inv.) [cj. aimer].
ZUCCHETTE	ZUCCHETTE n.f. (= zuchette) Petite courge d’Italie.
ZUCCHETTES	ZUCCHETTE n.f. (= zuchette) Petite courge d’Italie.
ZUCHETTE	ZUCHETTE n.f. (= zucchette) Petite courge d’Italie.
ZUCHETTES	ZUCHETTE n.f. (= zucchette) Petite courge d’Italie.
ZUGZWANG	ZUGZWANG n.m. Aux échecs, coup forcé.
ZUGZWANGS	ZUGZWANG n.m. Aux échecs, coup forcé.
ZUMBA	ZUMBA n.f. (Nom déposé) Gymnastique pratiquée sur de la musique de danse latine.
ZUMBAS	ZUMBA n.f. (Nom déposé) Gymnastique pratiquée sur de la musique de danse latine.
ZUP	ZUP n.f. Zone à urbaniser par priorité.
ZUPS	ZUP n.f. Zone à urbaniser par priorité.
ZURICHOIS	ZURICHOIS, E adj. De Zurich (Suisse).
ZURICHOISE	ZURICHOIS, E adj. De Zurich (Suisse).
ZURICHOISES	ZURICHOIS, E adj. De Zurich (Suisse).
ZUT	ZUT interj.
ZUTIQUE	ZUTIQUE adj. Du groupe des zutistes.
ZUTIQUES	ZUTIQUE adj. Du groupe des zutistes.
ZUTISTE	ZUTISTE n. Membre d’un cercle de poètes qui disaient zut à tout (fin du XIXe s.).
ZUTISTES	ZUTISTE n. Membre d’un cercle de poètes qui disaient zut à tout (fin du XIXe s.).
ZWANZA	ZWANZER v. (p.p.inv.) [cj. aimer]. Belg. Plaisanter.
ZWANZAI	ZWANZER v. (p.p.inv.) [cj. aimer]. Belg. Plaisanter.
ZWANZAIENT	ZWANZER v. (p.p.inv.) [cj. aimer]. Belg. Plaisanter.
ZWANZAIS	ZWANZER v. (p.p.inv.) [cj. aimer]. Belg. Plaisanter.
ZWANZAIT	ZWANZER v. (p.p.inv.) [cj. aimer]. Belg. Plaisanter.
ZWANZAMES	ZWANZER v. (p.p.inv.) [cj. aimer]. Belg. Plaisanter.
ZWANZANT	ZWANZER v. (p.p.inv.) [cj. aimer]. Belg. Plaisanter.
ZWANZAS	ZWANZER v. (p.p.inv.) [cj. aimer]. Belg. Plaisanter.
ZWANZASSE	ZWANZER v. (p.p.inv.) [cj. aimer]. Belg. Plaisanter.
ZWANZASSENT	ZWANZER v. (p.p.inv.) [cj. aimer]. Belg. Plaisanter.
ZWANZASSES	ZWANZER v. (p.p.inv.) [cj. aimer]. Belg. Plaisanter.
ZWANZASSIEZ	ZWANZER v. (p.p.inv.) [cj. aimer]. Belg. Plaisanter.
ZWANZASSIONS	ZWANZER v. (p.p.inv.) [cj. aimer]. Belg. Plaisanter.
ZWANZAT	ZWANZER v. (p.p.inv.) [cj. aimer]. Belg. Plaisanter.
ZWANZATES	ZWANZER v. (p.p.inv.) [cj. aimer]. Belg. Plaisanter.
ZWANZE	ZWANZE n.f. Belg. Plaisanterie.
ZWANZENT	ZWANZER v. (p.p.inv.) [cj. aimer]. Belg. Plaisanter.
ZWANZER	ZWANZER v. (p.p.inv.) [cj. aimer]. Belg. Plaisanter.
ZWANZERA	ZWANZER v. (p.p.inv.) [cj. aimer]. Belg. Plaisanter.
ZWANZERAI	ZWANZER v. (p.p.inv.) [cj. aimer]. Belg. Plaisanter.
ZWANZERAIENT	ZWANZER v. (p.p.inv.) [cj. aimer]. Belg. Plaisanter.
ZWANZERAIS	ZWANZER v. (p.p.inv.) [cj. aimer]. Belg. Plaisanter.
ZWANZERAIT	ZWANZER v. (p.p.inv.) [cj. aimer]. Belg. Plaisanter.
ZWANZERAS	ZWANZER v. (p.p.inv.) [cj. aimer]. Belg. Plaisanter.
ZWANZERENT	ZWANZER v. (p.p.inv.) [cj. aimer]. Belg. Plaisanter.
ZWANZEREZ	ZWANZER v. (p.p.inv.) [cj. aimer]. Belg. Plaisanter.
ZWANZERIEZ	ZWANZER v. (p.p.inv.) [cj. aimer]. Belg. Plaisanter.
ZWANZERIONS	ZWANZER v. (p.p.inv.) [cj. aimer]. Belg. Plaisanter.
ZWANZERONS	ZWANZER v. (p.p.inv.) [cj. aimer]. Belg. Plaisanter.
ZWANZERONT	ZWANZER v. (p.p.inv.) [cj. aimer]. Belg. Plaisanter.
ZWANZES	ZWANZE n.f. Belg. Plaisanterie.
ZWANZEUR	ZWANZEUR, EUSE n. Belg. Blagueur.
ZWANZEURS	ZWANZEUR, EUSE n. Belg. Blagueur.
ZWANZEUSE	ZWANZEUR, EUSE n. Belg. Blagueur.
ZWANZEUSES	ZWANZEUR, EUSE n. Belg. Blagueur.
ZWANZEZ	ZWANZER v. (p.p.inv.) [cj. aimer]. Belg. Plaisanter.
ZWANZIEZ	ZWANZER v. (p.p.inv.) [cj. aimer]. Belg. Plaisanter.
ZWANZIONS	ZWANZER v. (p.p.inv.) [cj. aimer]. Belg. Plaisanter.
ZWANZONS	ZWANZER v. (p.p.inv.) [cj. aimer]. Belg. Plaisanter.
ZWIEBACK	ZWIEBACK n.m. Helv. Biscotte sucrée.
ZWIEBACKS	ZWIEBACK n.m. Helv. Biscotte sucrée.
ZWINGLIANISME	ZWINGLIANISME n.m. Doctrine religieuse du réformateur suisse Zwingli (XVIe s.).
ZWINGLIANISMES	ZWINGLIANISME n.m. Doctrine religieuse du réformateur suisse Zwingli (XVIe s.).
ZWINGLIEN	ZWINGLIEN, ENNE n. et adj. Adepte du zwinglianisme.
ZWINGLIENNE	ZWINGLIEN, ENNE n. et adj. Adepte du zwinglianisme.
ZWINGLIENNES	ZWINGLIEN, ENNE n. et adj. Adepte du zwinglianisme.
ZWINGLIENS	ZWINGLIEN, ENNE n. et adj. Adepte du zwinglianisme.
ZYDECO	ZYDECO n.m. ou f. Musique populaire, en Louisiane.
ZYDECOS	ZYDECO n.m. ou f. Musique populaire, en Louisiane.
ZYEUTA	ZYEUTER v. [cj. aimer]. (= zieuter) Fam. Regarder.
ZYEUTAI	ZYEUTER v. [cj. aimer]. (= zieuter) Fam. Regarder.
ZYEUTAIENT	ZYEUTER v. [cj. aimer]. (= zieuter) Fam. Regarder.
ZYEUTAIS	ZYEUTER v. [cj. aimer]. (= zieuter) Fam. Regarder.
ZYEUTAIT	ZYEUTER v. [cj. aimer]. (= zieuter) Fam. Regarder.
ZYEUTAMES	ZYEUTER v. [cj. aimer]. (= zieuter) Fam. Regarder.
ZYEUTANT	ZYEUTER v. [cj. aimer]. (= zieuter) Fam. Regarder.
ZYEUTAS	ZYEUTER v. [cj. aimer]. (= zieuter) Fam. Regarder.
ZYEUTASSE	ZYEUTER v. [cj. aimer]. (= zieuter) Fam. Regarder.
ZYEUTASSENT	ZYEUTER v. [cj. aimer]. (= zieuter) Fam. Regarder.
ZYEUTASSES	ZYEUTER v. [cj. aimer]. (= zieuter) Fam. Regarder.
ZYEUTASSIEZ	ZYEUTER v. [cj. aimer]. (= zieuter) Fam. Regarder.
ZYEUTASSIONS	ZYEUTER v. [cj. aimer]. (= zieuter) Fam. Regarder.
ZYEUTAT	ZYEUTER v. [cj. aimer]. (= zieuter) Fam. Regarder.
ZYEUTATES	ZYEUTER v. [cj. aimer]. (= zieuter) Fam. Regarder.
ZYEUTE	ZYEUTER v. [cj. aimer]. (= zieuter) Fam. Regarder.
ZYEUTEE	ZYEUTER v. [cj. aimer]. (= zieuter) Fam. Regarder.
ZYEUTEES	ZYEUTER v. [cj. aimer]. (= zieuter) Fam. Regarder.
ZYEUTENT	ZYEUTER v. [cj. aimer]. (= zieuter) Fam. Regarder.
ZYEUTER	ZYEUTER v. [cj. aimer]. (= zieuter) Fam. Regarder.
ZYEUTERA	ZYEUTER v. [cj. aimer]. (= zieuter) Fam. Regarder.
ZYEUTERAI	ZYEUTER v. [cj. aimer]. (= zieuter) Fam. Regarder.
ZYEUTERAIENT	ZYEUTER v. [cj. aimer]. (= zieuter) Fam. Regarder.
ZYEUTERAIS	ZYEUTER v. [cj. aimer]. (= zieuter) Fam. Regarder.
ZYEUTERAIT	ZYEUTER v. [cj. aimer]. (= zieuter) Fam. Regarder.
ZYEUTERAS	ZYEUTER v. [cj. aimer]. (= zieuter) Fam. Regarder.
ZYEUTERENT	ZYEUTER v. [cj. aimer]. (= zieuter) Fam. Regarder.
ZYEUTEREZ	ZYEUTER v. [cj. aimer]. (= zieuter) Fam. Regarder.
ZYEUTERIEZ	ZYEUTER v. [cj. aimer]. (= zieuter) Fam. Regarder.
ZYEUTERIONS	ZYEUTER v. [cj. aimer]. (= zieuter) Fam. Regarder.
ZYEUTERONS	ZYEUTER v. [cj. aimer]. (= zieuter) Fam. Regarder.
ZYEUTERONT	ZYEUTER v. [cj. aimer]. (= zieuter) Fam. Regarder.
ZYEUTES	ZYEUTER v. [cj. aimer]. (= zieuter) Fam. Regarder.
ZYEUTEZ	ZYEUTER v. [cj. aimer]. (= zieuter) Fam. Regarder.
ZYEUTIEZ	ZYEUTER v. [cj. aimer]. (= zieuter) Fam. Regarder.
ZYEUTIONS	ZYEUTER v. [cj. aimer]. (= zieuter) Fam. Regarder.
ZYEUTONS	ZYEUTER v. [cj. aimer]. (= zieuter) Fam. Regarder.
ZYGENE	ZYGÈNE n.f. Papillon diurne. - Requin-marteau.
ZYGENES	ZYGÈNE n.f. Papillon diurne. - Requin-marteau.
ZYGNEMA	ZYGNÉMA n.m. Algue des eaux stagnantes.
ZYGNEMAS	ZYGNÉMA n.m. Algue des eaux stagnantes.
ZYGOMA	ZYGOMA n.m. Anat. Os de la pommette.
ZYGOMAS	ZYGOMA n.m. Anat. Os de la pommette.
ZYGOMATIQUE	ZYGOMATIQUE 1. adj. Anat. Relatif à la pommette. 2. n.m. Muscle de la pommette.
ZYGOMATIQUES	ZYGOMATIQUE 1. adj. Anat. Relatif à la pommette. 2. n.m. Muscle de la pommette.
ZYGOMORPHE	ZYGOMORPHE adj. Bot. (Fleur) qui présente une symétrie bilatérale.
ZYGOMORPHES	ZYGOMORPHE adj. Bot. (Fleur) qui présente une symétrie bilatérale.
ZYGOMYCETE	ZYGOMYCÈTE n.m. Moisissure.
ZYGOMYCETES	ZYGOMYCÈTE n.m. Moisissure.
ZYGOPETALE	ZYGOPÉTALE n.m. (= zygopetalum) Variété d’orchidée.
ZYGOPETALES	ZYGOPÉTALE n.m. (= zygopetalum) Variété d’orchidée.
ZYGOPETALUM	ZYGOPETALUM n.m. (= zygopétale) Variété d’orchidée.
ZYGOPETALUMS	ZYGOPETALUM n.m. (= zygopétale) Variété d’orchidée.
ZYGOPHYLLACEE	ZYGOPHYLLACÉE n.f. Plante dicotylédone, type gaïac.
ZYGOPHYLLACEES	ZYGOPHYLLACÉE n.f. Plante dicotylédone, type gaïac.
ZYGOPTERE	ZYGOPTÈRE n.m. Insecte, type demoiselle.
ZYGOPTERES	ZYGOPTÈRE n.m. Insecte, type demoiselle.
ZYGOSPORE	ZYGOSPORE n.f. Bot. Œuf propre aux zygomycètes.
ZYGOSPORES	ZYGOSPORE n.f. Bot. Œuf propre aux zygomycètes.
ZYGOTE	ZYGOTE n.m. Biol. Cellule résultant de la fusion de deux gamètes de sexes opposés.
ZYGOTENE	ZYGOTÈNE n.m. et adj. Deuxième stade de la méiose.
ZYGOTENES	ZYGOTÈNE n.m. et adj. Deuxième stade de la méiose.
ZYGOTES	ZYGOTE n.m. Biol. Cellule résultant de la fusion de deux gamètes de sexes opposés.
ZYKLON	ZYKLON n.m. Acide utilisé dans les chambres à gaz nazies.
ZYKLONS	ZYKLON n.m. Acide utilisé dans les chambres à gaz nazies.
ZYMASE	ZYMASE n.f. Enzyme.
ZYMASES	ZYMASE n.f. Enzyme.
ZYMOGENE	ZYMOGÈNE adj. et n.m. Qui produit une enzyme active.
ZYMOGENES	ZYMOGÈNE adj. et n.m. Qui produit une enzyme active.
ZYMOLOGIE	ZYMOLOGIE n.f. Étude chimique des fermentations.
ZYMOLOGIES	ZYMOLOGIE n.f. Étude chimique des fermentations.
ZYMOTECHNIE	ZYMOTECHNIE n.f. Étude des ferments et des fermentations.
ZYMOTECHNIES	ZYMOTECHNIE n.f. Étude des ferments et des fermentations.
ZYMOTIQUE	ZYMOTIQUE adj. Relatif aux ferments solubles.
ZYMOTIQUES	ZYMOTIQUE adj. Relatif aux ferments solubles.
ZYTHOLOGIE	ZYTHOLOGIE n.f. Biérologie.
ZYTHOLOGIES	ZYTHOLOGIE n.f. Biérologie.
ZYTHOLOGUE	ZYTHOLOGUE n.
ZYTHOLOGUES	ZYTHOLOGUE n.
ZYTHON	ZYTHON n.m. (= zythum) Bière fermentée de l’ancienne Égypte.
ZYTHONS	ZYTHON n.m. (= zythum) Bière fermentée de l’ancienne Égypte.
ZYTHUM	ZYTHUM n.m. (= zython) Bière fermentée de l’ancienne Égypte.
ZYTHUMS	ZYTHUM n.m. (= zython) Bière fermentée de l’ancienne Égypte.
